1111111111111111111111111111
1000000000000000000000000001
1000000000000001000000000001
1000000000000001000000000001
1000000000001111000000000001
1000000000000000000000000001
1000000000000000000000000001
1000000000001000000000000001
1000000000001000000000000001
1000000000011000000000000001
1000000111110000000000000001
1000000010000000000000000001
1000000010000000000000000001
1000000010000000000000000001
1000000010000000000000000001
1000000001000000000000000001
1000000001000000000000000001
1000000000000000000000000001
1000000000000000000000000001
1000000000000000000000000001
1000000000000000000000000001
1000000000000000000000000001
1000000000000000000000000001
1000000000000000000000000001
1000000000011111111000000001
1000000000000000000000000001
1000000000000000000000000001
1000000000000000000000000001
1000000000000000000000000001
1000000000000000000000000001
1111111111111111111111111111